2G=Second Generation of mobile telecommunications technology
3GPP2=3rd Generation Partnership Project 2
3GPP=The 3rd Generation Partnership Project
3G=Third Generation of mobile telecommunications technology
4G=Forth Generation of mobile telecommunications technology
AAA=Authentication, Authorization and Accounting
AAS=Active Antenna System
ACL=Access Control List
ADC=Automatic Data Collection
AEM=All Employee Meeting
AGC=Automatic Gain Control
ALEX=Active Library Explorer
ALM=Application Lifecycle Management
ANT=Antenna
ANTPI=Antenna Port Interface
APC=Alarm Power Climate
API=Application Programming Interface
ARFCN=Absolute Radio Frequency Channel Number
ARP=Antenna Reference Point
ATM=Asynchronous Transfer Mode
AVLI=Availability Log Interface
AXC=Antenna Carrier Control
BB=Base Band
BC=Board Controller
BCI=Board Control Interface
BER=Bit Error Rate
BIRP=Baseband Interconnection Reference Point
BSC=Base Station Controller		
BSS=Business Support System
BVI=Bridge Virtual Interface
CA=Capacity
CAST=Cost And Scoping Tool
CAT=Common Access Tier
CAT=Common Architecture Technology
CBST=Corporate Basic Standards
CCB=Change Control Board
CCM=Continuity Check Messages
CDC= Centers For Disease Control And Prevention
CDMA=Code Division Multiple Access
CFD=Channel Filter Delay
CFM=Connectivity Fault Management
CGAI=Carrier Group Administration Interface
CG=Carrier Grade
CGCI=Carrier Group Control Interface
CGQI=Carrier Group Query Interface
CM=Configuration Management
COLI=Command Line
CoS=Classes of Service
CPI=Customer Product Information
CPP=Connectivity Packet Platform
CPRI=Common Public Radio Interface
CSS=Cascading Style Sheets
C-VLAN=Customer VLAN
CXC=load modules
CXP=delivery packages
DBB=Digital Building Block
DCG=Data Collection Guidline
DCI=Device Control Interface
DHCP=Dynamic Host Configuration
DL=Downlink
DMS=Digital Multiplex System
DNS=Domain Name System
DPD=Digital Pre Distortion
DU=Digital Unit
DUL=Digital Unit LTE
EAG=Ericsson Architecture Guide
EARFCN=E-UTRA Absolute Radio Frequency Channel Number
EBN=Ericsson Business Network
EBP=Ericsson Business Process
ECD=Ericsson Corporate Directory
ECN=Ericsson Corporate Network
EDAVS=Ericsson Device & Application Verification Services
EDD=Ericsson Germany GmbH
EGAD=Ericsson Global Active Directory
EHPT=Ericsson Hewlett-Packard Telecommunications
ENodeB=E-UTRAN NodeB. Also known as eNB
ENUM=E.164 Number Mapping
EOLS=Ericsson Open Link Shortener
EOW=Ericsson Open Wiki
EPG=Evolved Packet Gateway
EQNA=Ericsson Questions and Answers
EriCA=Ericsson Certificate Authority
ERIM=Ericsson Information Management
EVPM=Enhanced Video Pacing Module
FB=Filter Branch
FDD=Frequency Division Duplex
FI=Fault Indication
FM=Fault and Alarm Management
FOSS=Free Open Source Software
FRO=Facade Resource Object
FRU=Field Replacement Unit
FU=Function
FW=Frame Work
GCH=Global Competence Hub
GPRS=General Packet Radio Service
GSC=Global Service Center
GSM=Global System for Mobile Communications (Groupe Sp√©cial Mobile)
GST=Global Search Tool
GUI=Graphical User Interface
HAL=Hardware Abstraction Layer
HR=Human Resources
HSDPA=High Speed Downlink Packet Access
HSPA=High Speed Packet Access is an amalgamation of HSUPA & HSDPA
HSUPA=High Speed Uplink Packet Access (HSUPA)
HTML=HyperText Markup Language
HW=Hardware
ICT=Information and Communications Technology
IDE=Integrated Development Environment
IETF=Internet Engineering Task Force
IET=Internal Ericsson Troubleshooting
IfU=Interface Units
IPM=Individual Performance Management
IRU=Indoor Radio Unit
ISP=In-Service Performance
IT=Information Technology
ITM=Integrated Talent Management System
ITSC=IT Service Catalog
ITTE=Group IT & Test Environments		
IUANT=3GPP specified interface to the antenna units (RET and TMA)
JCAT=JAVA CRISM Analysis Tool
LBM=Loopback Message
LBR=Loopback Reply
LDAP=Lightweight Directory Access Protocol
LDLI=Load List Interfaces
LLI=Load List Interface
LMC=Load Module Container
LSO=Local Service Organization
LTE=Long-term evolution (4G)
LTMs=Link Trace Messages
LTR=Link Trace Reply
LTU=Local Timing Unit
MA=Maintenance Associations
MAN=Man Machine Interface
MAO=Management Adaption Object
MEP=Maintenance Association End Point
MIB=Manage Interbase Base
MIP=Maintenance Association Intermediate Point
MMCS=Multimedia Messaging Center
MO=Managed Object
MOM=Managed Object Model
MP=Main Processor
MSI=Multi Standard Interface
MS=Mobile Station / Multi Standard / Milestone
MTBI=Market Trends and Business Intelligence
MTM=Maintenance Trunk Module
NAT=Network Address Translation
NC=Node Control
NDS=Network Design Specification
NETCONF=Network Configuration Protocol, is an IETF network management protocol
NSN=Nokia Siemens Networks
NTP=Network Time Protocol
OAM=Operations And Maintenance
OAMPDUs=OAM Protocol Data Units
OBSC=Observability Counters
OBSE=Observability Events
OCXO=Oven Controlled Crystal Oscillator
OPEX=Operating Expense / Operating Expenditure / Operational Expense / Operational Expenditure
OSE=Operating System Embedded
OSS=Open Source Software / Operations Support System
OSS-RC=Operations Support System, Radio and Core network
PCP=Priority Code Point
PDU=Protocol Data Unit / Product Development Unit
PE=Performance
PLCM=Product Lifecycle Management
PM=Performance Monitoring
PPP=Point to Point Protocol
PTP=Precision Time Protocol
PU=Power Unit
QoS=Quality of Service
RACOM=Remote Access Communication
RAS=Radio and Sector (Analogue part of Modem)
RAT=Radio Access Technology unit
RBB=Radio Building Block
RBS=Radio Base Station
RC=Radio & Core
RCS=Radio Control System
RDI= Radio Data Insight
REC=Radio Equipment Control unit
RERC=RBS Equipment and Resource Control
RET=Remote Electrical Tilt
RICM-DCI=Radio Interface Control Main - Device Control Interface
RICM=Radio Interface Control Main unit
RICR=Radio Interface Control Remote
RI=Radio Interface / Rich Communication Services
RMCI=Radio Measurement Control Interface
RNC=Radio Network Controller
RO=Resource Object
RPC=Remote Procedure Call
RRI=Radio Unit Resource Interface
RRU=Remote Radio Unit
RSG=Ericsson Remote Support Gateway
RTU=Remote Terminal Unit / Radio Test Utilities
RU=Radio Unit
RUS=Radio Unit multi-Standard
RWCE=Region Western and Central Europe
SBPS=Symbol Based Power Save
SCSPI=System Clock Status Propagation Interface
SFD=Synchroneous Fine Delay
SFTP=Secure File Transfer Protocol
SICOP=Structured Integration project COst and Price
SI=Systems Integration
SMG=Sync Mark Generator
SM=Software Management
SNMP=Simple Network Management Protocol
SPOC=Single Point of Contact
SQL=Structured Query Language
SSH=Secure Shell
SSI=Server System Infrastructure
SSM=Synchronous Status Message
SVG=Scalable Vector Graphics
SWU=Software Units
SynchE=Synchronous Ethernet
TAC=Tracking Area Code
TCP=Transmission Control Protocol
TC=Test Case
TCU-BC=TCU Board Controller
TCU=Transport Connectivity Unit
TCU-UC=TCU Unit Controller
TDCI=Timing Distribution Control Interface
TDC=Timing Distribution Control
TDD=Time Division Duplex
TDI=Test and Debug Interface
TDM=Tactical Dimensioning Meeting / Test Development Model / Time-division multiplexing
TMA=Tower Mounted Amplifier
TN=Transport Network / Telefonplan
TR-DCI=Traffic - Digital Control Interface
TRP=Time Reference Point
TR=Traffic Device / Trouble Report
TTL=Time To Live
TUM=Timing Unit Module
TWAMP=Two-Way Active Measurement Protocol
UE=User Equipment
ULCA=Uplink Carrier Aggregation
ULF=Unified Log Format
ULSA=Uplink Spectrum Analyzer
UL=Uplink
UML=Unified Modeling Language
UMTS=Universal Mobile Telecommunications System, also known as 3G
UNI-C=User Network Interface - Customer Side
UNI-N=User Network Interface - Network Side
VLAN=Virtual Local Area Networks
WCDMA=Wideband Code Division Multiple Access (3G)
WM=Washing Machine
XFT=Cross (X) Functional Team
